*****************
*1              *
*               *
*               *
*               *
*               *
*               *
*               *
*               *
*               *
*               *
*               *
*****************
